0000000000000000000000
0313110011100000000000
0000010010100010000000
0000010030111110000000
0313110000001000111111
0000011111111111100000
0000010000010000100000
0313110000010000111111
0000010000313131100000
0000010000100100100000
0020010000100100100000
0011113113113113111100
0000000010000100000100
0000000010000100333100
0000000010000100100000
0011311110000111100000
0010000010000000000000
0030330010000000000000
0010010010000000000000
0031310010000000000000
0000000010000000000000
0000000010000000000000
0000000000000000000000